CÓDIGO;DISCIPLINA;TEORIA;PRATICA;INDIVIDUAL;CRÉDITOS;RECOMENDAÇÕES;CATEGORIA
BC1425;Álgebra Linear;6;0;5;6;Geometria Analítica;OB
BC1424;Algoritmos e Estruturas de Dados I;2;2;4;4;Programação Orientada a Objetos;OL
EN3630;Aplicações de Microcontroladores;0;4;4;4;"Sistemas Microprocessado; Eletrônica Analógica Aplicada";OL
EN3626;Aplicações Multimídia em Voz, Áudio e Acústica;3;1;4;4;Introdução ao Processamento de Sinais de Voz, Áudio e Acústicos;OL
BC0001;Base Experimental das Ciências Naturais;0;3;2;3;;OB
BC0005;Bases Computacionais da Ciência;0;2;2;2;;OB
BC0004;Bases Epistemológicas da Ciência Moderna;3;0;4;3;;OB
BC0003;Bases Matemáticas;4;0;5;4;;OB
BC1419;Cálculo Numérico;3;1;4;4;Funções de Uma Variável;OB
BC0603;Ciência, Tecnologia e Sociedade;3;0;4;3;;OB
BC1519;Circuitos Elétricos e Fotônica;3;1;5;4;Fenômenos Eletromagnéticos;OB
EN2703;Circuitos Elétricos I;3;2;4;5;Circuitos Elétricos e Fotônica;OB
EN2611;Comunicação Digital;3;1;4;4;"Princípios de Comunicação; Sinais Aleatórios";OB
BC0506;Comunicação e Redes;3;0;4;3;;OB
EN2620;Comunicações Móveis;3;1;4;4;"Comunicação Digital; Propagação e Antenas";OB
EN2621;Comunicações Multimídia;2;2;4;4;Processamento Digital de Sinais;OB
EN2614;Comunicações Ópticas;3;1;4;4;Circuitos Elétricos e Fotônica;OB
EN2719;Dispositivos Eletrônicos;3;2;4;5;Circuitos Elétricos e Fotônica;OB
EN2720;Eletrônica Analógica Aplicada;3;2;4;5;Dispositivos Eletrônicos;OB
EN2605;Eletrônica Digital;4;2;4;6;Circuitos Elétricos e Fotônica;OB
BC0207;Energia: Origens, Conversão e Uso;2;0;4;2;;OB
EN3631;Engenharia de Sistemas de Comunicação e Missão Crítica;2;2;4;4;Processamento da Informação;OL
BC1508;Engenharia de Software;4;2;4;6;Algoritmos e Estruturas de Dados I;OL
BC1713;Engenharia Econômica;2;1;3;3;Não há;OB
EN1002;Engenharia Unificada I;0;3;5;3;Todas as disciplinas de Opção Limitada do BC&T (Obrigatórias para todas as Engenharias);OB
EN1004;Engenharia Unificada II;0;3;5;3;Engenharia Unificada I;OB
EN1601;Estágio Curricular I em Engenharia de Informação;0;7;0;7;Ver resolução de Estágio específica para o curso;OB
EN1602;Estágio Curricular II em Engenharia de Informação;0;7;0;7;Estágio Curricular I;OB
BC0102;Estrutura da Matéria;3;0;4;3;;OB
BC0602;Estrutura e Dinâmica Social;3;0;4;3;;OB
BC0209;Fenômenos Eletromagnéticos;3;2;6;5;;OB
BC0208;Fenômenos Mecânicos;3;2;6;5;;OB
BC0205;Fenômenos Térmicos;3;1;4;4;;OB
EN3604;Filtragem Adaptativa;3;1;4;4;"Sinais Aleatórios; Processamento Digital de Sinais";OL
BC0103;Física Quântica;3;0;4;3;;OB
BC0402;Funções de Uma Variável;4;0;6;4;;OB
BC0407;Funções de Várias Variáveis;4;0;4;4;;OB
BC1416;Fundamentos de Desenho e Projeto;1;3;4;4;Não há;OB
EN3622;Fundamentos de Processamento Gráfico;3;1;4;4;"Geometria Analítica; Álgebra Linear; Processamento da Informação; Programação de Software Embarcado";OL
BC0404;Geometria Analítica;3;0;6;3;;OB
EN3610;Gerenciamento e Interoperabilidade de Redes;3;1;4;4;Redes de Computadores;OL
EN3601;Informação e Sociedade;2;0;3;2;Não há;OL
EN3618;Informática Industrial;0;4;4;4;Eletrônica Digital;OL
BC1507;Instrumentação e Controle;3;1;5;4;"Introdução às Equações Diferenciais Ordinárias; Circuitos Elétricos e Fotônica";OB
BC0104;Interações Atômicas e Moleculares;3;0;4;3;;OB
BC0406;Introdução à Probabilidade e à Estatística;3;0;4;3;;OB
EN3620;Introdução ao Processamento de Sinais de Voz, Áudio e Acústicos;3;1;4;4;Processamento Digital de Sinais;OL
BC1710;Introdução às Engenharias;2;0;4;2;Não há;OB
BC0405;Introdução às Equações Diferenciais Ordinárias;4;0;4;4;;OB
EN3617;Jogos Digitais: Aspectos Técnicos e Aplicações;2;2;4;4;Processamento da Informação;OL
BC1105;Materiais e Suas Propriedades;3;1;5;4;Não há;OB
BC1103;Mecânica dos Fluidos I;3;1;5;4;Fenômenos Térmicos;OB
BC1104;Mecânica dos Sólidos I;3;1;5;4;"Funções de Uma Variável; Fenômenos Mecânicos; Geometria Analítica";OB
BC1707;Métodos Experimentais em Engenharia;0;3;2;3;"Circuitos Elétricos e Fotônica; Mecânica dos Fluidos I";OB
BC0504;Natureza da Informação;3;0;4;3;;OB
EN2613;Ondas Eletromagnéticas Aplicadas;3;1;4;4;Fenômenos Eletromagnéticos;OB
BC0304;Origem da Vida e Diversidade dos Seres Vivos;3;0;4;3;;OB
EN3627;Planejamento de Redes de Informação;2;2;4;4;Comunicação e Redes;OL
EN2608;Princípios de Comunicação;3;1;4;4;Transformadas em Sinais e Sistemas Lineares;OB
BC0505;Processamento da Informação;3;2;5;5;;OB
EN3605;Processamento de Informação em Línguas Naturais;3;1;4;4;Natureza da Informação;OL
EN3612;Processamento de Vídeo;3;1;4;4;"Comunicações Multimídia; Processamento Digital de Sinais";OL
EN2610;Processamento Digital de Sinais;4;0;4;4;Transformadas em Sinais e Sistemas Lineares;OB
EN3616;Programação de Dispositivos Móveis;0;2;4;2;Processamento da Informação;OL
EN2622;Programação de Software Embarcado;2;2;4;4;"Geometria Analítica; Álgebra Linear; Processamento da Infomação";OB
BC1501;Programação Orientada a Objetos;2;2;4;4;Não há;OL
EN3625;Projeto de Alta Frequência;2;2;4;4;"Ondas Eletromagnéticas Aplicadas; Eletrônica Analógica Aplicada; Sistemas de Micro-ondas";OL
EN3621;Projeto de Filtros Digitais;2;2;4;4;Processamento Digital de Sinais;OL
EN3628;Projeto de Sistemas de Comunicação;0;3;3;3;"Princípios de Comunicação; Comunicação Digital";OL
EN3629;Projeto de Sistemas Multimídia;0;3;3;3;"Comunicações Multimídia; Processamento de Vídeo; Introdução ao Processamento de Sinais de Voz, Áudio e Acústicos";OL
BC0002;Projeto Dirigido;0;2;10;2;;OB
EN2615;Propagação e Antenas;3;1;4;4;Ondas Eletromagnéticas Aplicadas;OB
EN3608;Redes de Alta Velocidade;3;1;4;4;Redes de Computadores;OL
BC1513;Redes de Computadores;3;1;4;4;Processamento da Informação;OB
EN3611;Segurança de Redes;3;1;4;4;Redes de Computadores;OL
EN3615;Simulação de Sistemas de Comunicação;2;2;4;4;"Princípios de Comunicação; Comunicação Digital";OL
EN2609;Sinais Aleatórios;4;0;4;4;"Introdução à Probabilidade e à Estatística; Transformadas em Sinais e Sistemas Lineares";OB
EN3624;Sistemas de Micro-ondas;3;1;4;4;"Ondas Eletromagnéticas Aplicadas; Eletrônica Analógica Aplicada";OL
EN3619;Sistemas Inteligentes;3;1;4;4;Não há;OL
EN2617;Sistemas Microprocessados;2;2;4;4;"Eletrônica Digital; Dispositivos Eletrônicos";OB
EN3623;Tecnologia de Redes Ópticas;4;0;4;4;Comunicações Ópticas;OL
EN2619;Telefonia Fixa Moderna;3;1;4;4;"Redes de Computadores; Princípios de Comunicação";OB
EN2612;Teoria da Informação e Códigos;4;0;4;4;Comunicação Digital;OB
EN3609;Teoria de Filas e Análise de Desempenho;3;1;4;4;"Sinais Aleatórios; Redes de Computadores";OL
BC1309;Termodinâmica Aplicada I;3;1;5;4;Fenômenos Térmicos;OB
EN1603;Trabalho de Graduação I em Engenharia de Informação;0;2;4;2;Ver resolução de TG específica para o curso;OB
EN1604;Trabalho de Graduação II em Engenharia de Informação;0;2;4;2;Trabalho de Graduação I;OB
EN1605;Trabalho de Graduação III em Engenharia de Informação;0;2;4;2;Trabalho de Graduação II;OB
BC0308;Transformações Bioquímicas;3;2;6;5;;OB
BC0306;Transformações nos Seres Vivos e Ambiente;3;0;4;3;;OB
BC0307;Transformações Químicas;3;2;6;5;;OB
BC1509;Transformadas em Sinais e Sistemas Lineares;4;0;4;4;Funções de Várias Variáveis;OB
EN3606;TV Digital;3;1;4;4;Comunicação Digital;OL
